...........
.>+++++++R.
.........+.
.R+R.L+L.+.
.+.+.+.+.+.
.+.+.X.+.+.
.+.+...+.+.
.+.L+++L.+.
.+.......+.
.R+++++++R.
...........
